1
*
WWWWWWWWWWWWWWWWWWWWWWWWWWWWWWWWWWWWWWWW
WLLLLLLLLLLLLLLLLLLWWLLLLLLLLLLLLLLLLLLW
WLLLLLLLLLLLLLLLLLLWWLLLLLLLLLLLLLLLLLLW
WLLLLLLLLLLLLLLLLLLLLLLLLLLLLLLLLLLLLLLW
WLLLLLLLLLLLLLLLLLLLLLLLLLLLLLLLLLLLLLLW
WLLLLLLLLLLLLLLLLLLWWLLLLLLLLLLLLLLLLLLW
WLLLLLLLLLLLLLLLLLLWWLLLLLLLLLLLLLLLLLLW
WWWWWWWWWWWWWWWWWWWWWWWWWWWWWWWWWWWWWWWW
*
Tangible porte1 50 200
Tangible porte2	50 400
Tangible porte3 50 1200

